9
SSSSSSSSSSSSSSSS
YYYYYYYYYYYYYYYY
MMMMMMMMMMMMMMMM
BBBBBBBBBBBBBBBB
RRRRRRRRRRRRRRRR
GGGGGGGGGGGGGGGG
CCCCCCCCCCCCCCCC
OOOOOOOOOOOOOOOO
WWWWWWWWWWWWWWWW