10
--ASA--ASA--ASA-
--AWA--AWA--AWA-
--AOA--AOA--AOA-
--ACA--ACA--ACA-
--AGA--AGA--AGA-
--ARA--ARA--ARA-
--ABA--ABA--ABA-
--AMA--AMA--AMA-
--AYA--AYA--AYA-
--AAA--AAA--AAA-